11111111111
10E000000C1
100000C0001
10P00000001
11111111111