11111111111
10000000001
1P000000001
1000ECCCCC1
10000CCCC01
11111111111