11111111111111111111111111111111111111111111
100000000000000000000000000000000000000001E1
1111111CCCCC111C111111C11111CCC1CCC111111101
1000000C000C000CC0000CC000000C000C00C0000101
1000000C000C000C0C00C0C000000C000C000C000101
1000000CCCCC0P0C00CC00C000C00C000C000C000101
1000000C000C000C000000C000C00C000C00C0000101
1111111C111C111C111111C111CCCC111CCC11111101
10000000000000000000000000000000000000000001
11111111111111111111111111111111111111111111